Rolling in the Deep - Adele
Someone Like You - Adele
Party Rock Anthem - LMFAO
Call Me Maybe - Carly Rae Jepsen
We Are Young - fun. featuring Janelle Mon√°e
Somebody That I Used to Know - Gotye featuring Kimbra
Gangnam Style - PSY
Thrift Shop - Macklemore & Ryan Lewis featuring Wanz
Blurred Lines - Robin Thicke featuring T.I. and Pharrell Williams
Royals - Lorde
Happy - Pharrell Williams
Dark Horse - Katy Perry featuring Juicy J
All About That Bass - Meghan Trainor
Uptown Funk - Mark Ronson featuring Bruno Mars
See You Again - Wiz Khalifa featuring Charlie Puth
Can't Stop the Feeling! - Justin Timberlake
Shape of You - Ed Sheeran
Despacito - Luis Fonsi and Daddy Yankee featuring Justin Bieber
Perfect - Ed Sheeran
Havana - Camila Cabello featuring Young Thug
God's Plan - Drake
SICKO MODE - Travis Scott
Thank U, Next - Ariana Grande
Old Town Road - Lil Nas X featuring Billy Ray Cyrus
Bad Guy - Billie Eilish
Senorita - Shawn Mendes and Camila Cabello
Dance Monkey - Tones and I
The Box - Roddy Ricch
Watermelon Sugar - Harry Styles
Levitating - Dua Lipa featuring DaBaby
Good 4 U - Olivia Rodrigo
Butter - BTS
Need to Know - Doja Cat
Heat Waves - Glass Animals
Deja Vu - Olivia Rodrigo
Fancy - Drake featuring Swizz Beatz and T.I.
Love Story - Taylor Swift
Drivers License - Olivia Rodrigo
Industry Baby - Lil Nas X and Jack Harlow
Beggin' - Maneskin
Kiss Me More - Doja Cat featuring SZA
Bad Habits - Ed Sheeran
Save Your Tears (Remix) - The Weeknd and Ariana Grande
Need to Know - Doja Cat
Good 4 U - Olivia Rodrigo
Stay - The Kid LAROI and Justin Bieber
Montero (Call Me by Your Name) - Lil Nas X
Industry Baby - Lil Nas X and Jack Harlow
Save Your Tears - The Weeknd and Ariana Grande
Butter - BTS
